abandon	v	
ability	n	
able	adj	
about	adv,prep	
above	adv,prep	
abroad	adv	
absolute	adj	
absolutely	adv	
academic	adj,n	
accept	v	
acceptable	adj	
access	n,v	
accident	n	
accommodation	n	
accompany	v	
according to	prep	
account	n,v	
accurate	adj	
accuse	v	
achieve	v	
achievement	n	
acknowledge	v	
acquire	v	
across	adv,prep	
act	n,v	
action	n	
active	adj	
activity	n	
actor	n	
actress	n	
actual	adj	
actually	adv	
ad	n	
adapt	v	
add	v	
addition	n	
additional	adj	
address	n,v	
administration	n	
admire	v	
admit	v	
adopt	v	
adult	adj,n	
advance	adj,n,v	
advanced	adj	
advantage	n	
adventure	n	
advertise	v	
advertisement	n	
advertising	n	
advice	n	
advise	v	
affair	n	
affect	v	
afford	v	
afraid	adj	
after	adv,conj,prep	
afternoon	n	
afterwards	adv	
again	adv	
against	prep	
age	n,v	
aged	adj	
agency	n	
agenda	n	
agent	n	
aggressive	adj	
ago	adv	
agree	v	
agreement	n	
ah	exclam	
ahead	adv	
aid	n,v	
aim	n,v	
air	n	
aircraft	n	
airline	n	
airport	n	
alarm	n,v	
album	n	
alcohol	n	
alcoholic	adj	
alive	adj	
all	adv,det,pron	
all right	adj,adv,exclam	
allow	v	
almost	adv	
alone	adj,adv	
along	adv,prep	
already	adv	
also	adv	
alter	v	
alternative	adj,n	
although	conj	
always	adv	
amazed	adj	
amazing	adj	
ambition	n	
ambitious	adj	
among	prep	
amount	n,v	
analyse	v	
analysis	n	
ancient	adj	
and	conj	
anger	n	
angle	n	
angry	adj	
animal	n	
ankle	n	
anniversary	n	
announce	v	
announcement	n	
annoy	v	
annoyed	adj	
annoying	adj	
annual	adj	
another	det,pron	
answer	n,v	
anxious	adj	
any	adv,det,pron	
anybody	pron	
anymore	adv	
anyone	pron	
anything	pron	
anyway	adv	
anywhere	adv,pron	
apart	adv	
apartment	n	
apologize	v	
app	n	
apparent	adj	
apparently	adv	
appeal	n,v	
appear	v	
appearance	n	
apple	n	
application	n	
apply	v	
appointment	n	
appreciate	v	
approach	n,v	
appropriate	adj	
approval	n	
approve	v	
approximately	adv	
April	n	
architect	n	
architecture	n	
area	n	
argue	v	
argument	n	
arise	v	
arm	n	
armed	adj	
arms	n	
army	n	
around	adv,prep	
arrange	v	
arrangement	n	
arrest	n,v	
arrival	n	
arrive	v	
art	n	
article	n	
artificial	adj	
artist	n	
artistic	adj	
as	adv,conj,prep	
ashamed	adj	
asleep	adj	
ask	v	
aspect	n	
assess	v	
assessment	n	
assignment	n	
assist	v	
assistant	adj,n	
associate	v	
associated	adj	
association	n	
assume	v	
at	prep	
athlete	n	
atmosphere	n	
attach	v	
attack	n,v	
attempt	n,v	
attend	v	
attention	exclam,n	
attitude	n	
attract	v	
attraction	n	
attractive	adj	
audience	n	
August	n	
aunt	n	
author	n	
authority	n	
autumn	n	
available	adj	
average	adj,n,v	
avoid	v	
award	n,v	
aware	adj	
away	adv	
awful	adj	
baby	n	
back	adj,adv,n,v	
background	n	
backwards	adv	
bacteria	n	
bad	adj	
badly	adv	
bag	n	
bake	v	
balance	n,v	
ball	n	
ban	n,v	
banana	n	
band	n	
bank	n	(money) 
bank	n	(river) 
bar	n,v	
barrier	n	
base	n,v	
baseball	n	
based	adj	
basketball	n	
basic	adj	
basically	adv	
basis	n	
bath	n	
bathroom	n	
battery	n	
battle	n,v	
be	auxiliary v,v	
beach	n	
bean	n	
bear	v	(deal with) 
bear	n	(animal) 
beat	n,v	
beautiful	adj	
beauty	n	
because	conj	
become	v	
bed	n	
bedroom	n	
bee	n	
beef	n	
beer	n	
before	adv,conj,prep	
beg	v	
begin	v	
beginning	n	
behave	v	
behaviour	n	
behind	adv,prep	
being	n	
belief	n	
believe	v	
bell	n	
belong	v	
below	adv,prep	
belt	n	
bend	n,v	
benefit	n,v	
bent	adj	
best	adj,adv,n	
bet	n,v	
better	adj,adv,n	
between	adv,prep	
beyond	adv,prep	
bicycle	n	
big	adj	
bike	n	
bill	n,v	
billion	number	
bin	n	
biology	n	
bird	n	
birth	n	
birthday	n	
biscuit	n	
bit	n	
bite	n,v	
bitter	adj	
black	adj,n	
blame	n,v	
blank	adj,n	
blind	adj	
block	n,v	
blog	n	
blonde	adj	
blood	n	
blow	v	
blue	adj,n	
board	n,v	
boat	n	
body	n	
boil	v	
bomb	n,v	
bond	n	
bone	n	
book	n,v	
boot	n	
border	n,v	
bored	adj	
boring	adj	
born	v	
borrow	v	
boss	n	
both	det,pron	
bother	v	
bottle	n	
bottom	adj,n	
bowl	n	
box	n	
boy	n	
boyfriend	n	
brain	n	
branch	n	
brand	n,v	
brave	adj	
bread	n	
break	n,v	
breakfast	n	
breast	n	
breath	n	
breathe	v	
breathing	n	
bride	n	
bridge	n	
brief	adj	
bright	adj	
brilliant	adj	
bring	v	
broad	adj	
broadcast	n,v	
broken	adj	
brother	n	
brown	adj,n	
brush	n,v	
bubble	n	
budget	n	
build	v	
building	n	
bullet	n	
bunch	n	
burn	n,v	
bury	v	
bus	n	
bush	n	
business	n	
businessman	n	
busy	adj	
but	conj,prep	
butter	n	
button	n	
buy	v	
by	adv,prep	
bye	exclam	
cable	n	
cafe	n	
cake	n	
calculate	v	
call	n,v	
calm	adj,n,v	
camera	n	
camp	n,v	
campaign	n,v	
camping	n	
campus	n	
can1	modal v	
can2	n	
cancel	v	
cancer	n	
candidate	n	
cannot	v	
cap	n	
capable	adj	
capacity	n	
capital	adj,n	
captain	n	
capture	n,v	
car	n	
card	n	
care	n,v	
career	n	
careful	adj	
carefully	adv	
careless	adj	
carpet	n	
carrot	n	
carry	v	
cartoon	n	
case	n	
cash	n	
cast	n,v	
castle	n	
cat	n	
catch	n,v	
category	n	
cause	n,v	
CD	n	
ceiling	n	
celebrate	v	
celebration	n	
celebrity	n	
cell	n	
cent	n	
central	adj	
centre	n,v	
century	n	
ceremony	n	
certain	adj	
certainly	adv	
chain	n,v	
chair	n,v	
chairman	n	
challenge	n,v	
champion	n	
chance	n	
change	n,v	
channel	n	
chapter	n	
character	n	
characteristic	adj,n	
charge	n,v	
charity	n	
chart	n,v	
chat	n,v	
cheap	adj,adv	
cheat	n,v	
check	n,v	
chef	n	
cheerful	adj	
cheese	n	
chemical	adj,n	
chemistry	n	
chest	n	
chicken	n	
chief	adj,n	
child	n	
childhood	n	
chip	n	
chocolate	n	
choice	n	
choose	v	
church	n	
cigarette	n	
cinema	n	
circle	n,v	
circumstance	n	
cite	v	
citizen	n	
city	n	
civil	adj	
claim	n,v	
class	n	
classic	adj,n	
classical	adj	
classroom	n	
clause	n	
clean	adj,v	
clear	adj,v	
clearly	adv	
clever	adj	
click	n,v	
client	n	
climate	n	
climb	n,v	
clock	n	
close1	n,v	
close2	adj,adv	
closed	adj	
closely	adv	
cloth	n	
clothes	n	
clothing	n	
cloud	n	
club	n	
clue	n	
coach	n,v	
coal	n	
coast	n	
coat	n	
code	n	
coffee	n	
coin	n	
cold	adj,n	
collapse	n,v	
colleague	n	
collect	v	
collection	n	
college	n	
colour	n	
coloured	adj	
column	n	
combination	n	
combine	v	
come	v	
comedy	n	
comfort	n,v	
comfortable	adj	
command	n,v	
comment	n,v	
commercial	adj,n	
commission	n,v	
commit	v	
commitment	n	
committee	n	
common	adj,n	
commonly	adv	
communicate	v	
communication	n	
community	n	
company	n	
compare	v	
comparison	n	
compete	v	
competition	n	
competitor	n	
competitive	adj	
complain	v	
complaint	n	
complete	adj,v	
completely	adv	
complex	adj,n	
complicated	adj	
component	n	
computer	n	
concentrate	v	
concentration	n	
concept	n	
concern	n,v	
concerned	adj	
concert	n	
conclude	v	
conclusion	n	
condition	n	
conduct	n,v	
conference	n	
confidence	n	
confident	adj	
confirm	v	
conflict	n,v	
confuse	v	
confused	adj	
confusing	adj	
connect	v	
connected	adj	
connection	n	
conscious	adj	
consequence	n	
conservative	adj,n	
consider	v	
consideration	n	
consist	v	
consistent	adj	
constant	adj	
constantly	adv	
construct	v	
construction	n	
consume	v	
consumer	n	
contact	n,v	
contain	v	
container	n	
contemporary	adj	
content1	n	
contest	n,v	
context	n	
continent	n	
continue	v	
continuous	adj	
contract	n,v	
contrast	n,v	
contribute	v	
contribution	n	
control	n,v	
convenient	adj	
conversation	n	
convert	v	
convince	v	
convinced	adj	
cook	n,v	
cooker	n	
cooking	n	
cool	adj,v	
copy	n,v	
core	adj,n	
corner	n	
corporate	adj	
correct	adj,v	
correctly	adv	
cost	n,v	
costume	n	
cottage	n	
cotton	n	
could	modal v	
council	n	
count	n,v	
country	n	
countryside	n	
county	n	
couple	n	
courage	n	
course	n	
court	n	
cousin	n	
cover	n,v	
covered	adj	
cow	n	
crash	n,v	
crazy	adj	
cream	adj,n	
create	v	
creation	n	
creative	adj	
creature	n	
credit	n,v	
crew	n	
crime	n	
criminal	adj,n	
crisis	n	
criterion	n	
critic	n	
critical	adj	
criticism	n	
criticize	v	
crop	n	
cross	n,v	
crowd	n	
crowded	adj	
crucial	adj	
cruel	adj	
cry	n,v	
cultural	adj	
culture	n	
cup	n	
cupboard	n	
cure	n,v	
curly	adj	
currency	n	
current	adj,n	
currently	adv	
curtain	n	
curve	n,v	
curved	adj	
custom	n	
customer	n	
cut	n,v	
cycle	n,v	
dad	n	
daily	adj,adv	
damage	n,v	
dance	n,v	
dancer	n	
dancing	n	
danger	n	
dangerous	adj	
dark	adj,n	
data	n	
date	n,v	
daughter	n	
day	n	
dead	adj	
deal	n,v	
dear	adj,exclam	
death	n	
debate	n,v	
debt	n	
decade	n	
December	n	
decent	adj	
decide	v	
decision	n	
declare	v	
decline	n,v	
decorate	v	
decoration	n	
decrease	n,v	
deep	adj,adv	
deeply	adv	
defeat	n,v	
defence	n	
defend	v	
define	v	
definite	adj	
definitely	adv	
definition	n	
degree	n	
delay	n,v	
deliberate	adj	
deliberately	adv	
delicious	adj	
delight	n,v	
delighted	adj	
deliver	v	
delivery	n	
demand	n,v	
demonstrate	v	
dentist	n	
deny	v	
department	n	
departure	n	
depend	v	
depressed	adj	
depressing	adj	
depth	n	
describe	v	
description	n	
desert	n,v	
deserve	v	
design	n,v	
designer	n	
desire	n,v	
desk	n	
desperate	adj	
despite	prep	
destination	n	
destroy	v	
detail	n,v	
detailed	adj	
detect	v	
detective	n	
determine	v	
determined	adj	
develop	v	
development	n	
device	n	
diagram	n	
dialogue	n	
diamond	n	
diary	n	
dictionary	n	
die	v	
diet	n	
difference	n	
different	adj	
differently	adv	
difficult	adj	
difficulty	n	
dig	v	
digital	adj	
dinner	n	
direct	adj,adv,v	
direction	n	
directly	adv	
director	n	
dirt	n	
dirty	adj	
disadvantage	n	
disagree	v	
disappear	v	
disappointed	adj	
disappointing	adj	
disaster	n	
disc	n	
discipline	n	
discount	n,v	
discover	v	
discovery	n	
discuss	v	
discussion	n	
disease	n	
dish	n	
dishonest	adj	
dislike	n,v	
dismiss	v	
display	n,v	
distance	n	
distribute	v	
distribution	n	
district	n	
divide	n,v	
division	n	
divorced	adj	
do	auxiliary v,v	
doctor	n	
document	n,v	
documentary	n	
dog	n	
dollar	n	
domestic	adj	
dominate	v	
donate	v	
door	n	
double	adj,adv,det,pron,v	
doubt	n,v	
down	adv,prep	
download	n,v	
downstairs	adj,adv	
downwards	adv	
dozen	det,n	
draft	n,v	
drag	v	
drama	n	
dramatic	adj	
draw	v	
drawing	n	
dream	n,v	
dress	n,v	
dressed	adj	
drink	n,v	
drive	n,v	
driver	n	
driving	n	
drop	n,v	
drug	n	
drum	n	
drunk	adj	
dry	adj,v	
due	adj	
during	prep	
dust	n	
duty	n	
DVD	n	
each	adv,det,pron	
ear	n	
early	adj,adv	
earn	v	
earth	n	
earthquake	n	
easily	adv	
east	adj,adv,n	
eastern	adj	
easy	adj	
eat	v	
economic	adj	
economy	n	
edge	n	
edit	v	
edition	n	
editor	n	
educate	v	
educated	adj	
education	n	
educational	adj	
effect	n	
effective	adj	
effectively	adv	
efficient	adj	
effort	n	
egg	n	
eight	number	
eighteen	number	
eighty	number	
either	adv,det,pron	
elderly	adj	
elect	v	
election	n	
electric	adj	
electrical	adj	
electricity	n	
electronic	adj	
element	n	
elephant	n	
eleven	number	
else	adv	
elsewhere	adv	
email	n,v	
embarrassed	adj	
embarrassing	adj	
emerge	v	
emergency	n	
emotion	n	
emotional	adj	
emphasis	n	
emphasize	v	
employ	v	
employee	n	
employer	n	
employment	n	
empty	adj,v	
enable	v	
encounter	n,v	
encourage	v	
end	n,v	
ending	n	
enemy	n	
energy	n	
engage	v	
engaged	adj	
engine	n	
engineer	n	
engineering	n	
enhance	v	
enjoy	v	
enormous	adj	
enough	adv,det,pron	
enquiry	n	
ensure	v	
enter	v	
entertain	v	
entertainment	n	
enthusiasm	n	
enthusiastic	adj	
entire	adj	
entirely	adv	
entrance	n	
entry	n	
environment	n	
environmental	adj	
episode	n	
equal	adj,n,v	
equally	adv	
equipment	n	
error	n	
escape	n,v	
especially	adv	
essay	n	
essential	adj	
establish	v	
estate	n	
estimate	n,v	
ethical	adj	
euro	n	
evaluate	v	
even	adj,adv	
evening	n	
event	n	
eventually	adv	
ever	adv	
every	det	
everybody	pron	
everyday	adj	
everyone	pron	
everything	pron	
everywhere	adv	
evidence	n	
evil	adj,n	
exact	adj	
exactly	adv	
exam	n	
examination	n	
examine	v	
example	n	
excellent	adj	
except	conj,prep	
exchange	n,v	
excited	adj	
excitement	n	
exciting	adj	
excuse	n,v	
executive	adj,n	
exercise	n,v	
exhibition	n	
exist	v	
existence	n	
expand	v	
expect	v	
expectation	n	
expected	adj	
expedition	n	
expense	n	
expensive	adj	
experience	n,v	
experienced	adj	
experiment	n,v	
expert	adj,n	
explain	v	
explanation	n	
explode	v	
exploration	n	
explore	v	
explosion	n	
export	n,v	
expose	v	
express	v	
expression	n	
extend	v	
extent	n	
external	adj	
extra	adj,adv,n	
extraordinary	adj	
extreme	adj,n	
extremely	adv	
eye	n	
face	n,v	
facility	n	
fact	n	
factor	n	
factory	n	
fail	v	
failure	n	
fair	adj	
fairly	adv	
faith	n	
fall	n,v	
false	adj	
familiar	adj	
family	adj,n	
famous	adj	
fan	n	
fancy	adj,v	
fantastic	adj	
far	adj,adv	
farm	n,v	
farmer	n	
farming	n	
fascinating	adj	
fashion	n	
fashionable	adj	
fast	adj,adv	
fasten	v	
fat	adj,n	
father	n	
fault	n	
favour	n,v	
favourite	adj,n	
fear	n,v	
feather	n	
feature	n,v	
February	n	
fee	n	
feed	n,v	
feedback	n	
feel	n,v	
feeling	n	
fellow	adj	
female	adj,n	
fence	n	
festival	n	
few	adj,det,pron	
fiction	n	
field	n	
fifteen	number	
fifth	number	
fifty	number	
fight	n,v	
fighting	n	
figure	n,v	
file	n,v	
fill	v	
film	n,v	
final	adj,n	
finally	adv	
finance	n,v	
financial	adj	
find	v	
finding	n	
fine	adj	
finger	n	
finish	n,v	
fire	n,v	
firm	n	
first	adv,det,n,number	
firstly	adv	
fish	n,v	
fishing	n	
fit	adj,v	
fitness	n	
five	number	
fix	n,v	
fixed	adj	
flag	n	
flame	n	
flash	n,v	
flat	adj,n	
flexible	adj	
flight	n	
float	v	
flood	n,v	
floor	n	
flour	n	
flow	n,v	
flower	n	
flu	n	
fly	n,v	
flying	adj,n	
focus	n,v	
fold	n,v	
folding	adj	
folk	adj,n	
follow	v	
following	adj,n,prep	
food	n	
foot	n	
football	n	
for	prep	
force	n,v	
foreign	adj	
forest	n	
forever	adv	
forget	v	
forgive	v	
fork	n	
form	n,v	
formal	adj	
former	adj	
fortunately	adv	
fortune	n	
forty	number	
forward	adj,adv	
found	v	
four	number	
fourteen	number	
fourth	number	
frame	n,v	
free	adj,adv,v	
freedom	n	
freeze	v	
frequency	n	
frequently	adv	
fresh	adj	
Friday	n	
fridge	n	
friend	n	
friendly	adj	
friendship	n	
frighten	v	
frightened	adj	
frightening	adj	
frog	n	
from	prep	
front	adj,n	
frozen	adj	
fruit	n	
fry	v	
fuel	n,v	
full	adj	
fully	adv	
fun	adj,n	
function	n,v	
fund	n,v	
fundamental	adj	
funding	n	
funny	adj	
fur	n	
furniture	n	
further	adj,adv	
furthermore	adv	
future	adj,n	
gain	n,v	
gallery	n	
game	n	
gang	n	
gap	n	
garage	n	
garden	n	
gas	n	
gate	n	
gather	v	
general	adj	
generally	adv	
generate	v	
generation	n	
generous	adj	
genre	n	
gentle	adj	
gentleman	n	
geography	n	
get	v	
ghost	n	
giant	adj,n	
gift	n	
girl	n	
girlfriend	n	
give	v	
glad	adj	
glass	n	
global	adj	
glove	n	
go	n,v	
goal	n	
god	n	
gold	adj,n	
golf	n	
good	adj,n	
goodbye	exclam,n	
goods	n	
govern	v	
government	n	
grab	v	
grade	n,v	
gradually	adv	
graduate	n,v	
grain	n	
grand	adj	
grandfather	n	
grandmother	n	
grandparent	n	
grant	n,v	
grass	n	
grateful	adj	
great	adj	
green	adj,n	
greet	v	
grey	adj,n	
ground	n	
group	n	
grow	v	
growth	n	
guarantee	n,v	
guard	n,v	
guess	n,v	
guest	n	
guide	n,v	
guilty	adj	
guitar	n	
gun	n	
guy	n	
gym	n	
habit	n	
hair	n	
half	adv,det,n,pron	
hall	n	
hand	n,v	
handle	n,v	
hang	v	
happen	v	
happily	adv	
happiness	n	
happy	adj	
hard	adj,adv	
hardly	adv	
harm	n,v	
harmful	adj	
hat	n	
hate	n,v	
have	auxiliary v,v	
have to	modal v	
he	pron	
head	n,v	
headache	n	
headline	n	
health	n	
healthy	adj	
hear	v	
hearing	n	
heart	n	
heat	n,v	
heating	n	
heaven	n	
heavily	adv	
heavy	adj	
heel	n	
height	n	
helicopter	n	
hell	n	
hello	exclam,n	
help	n,v	
helpful	adj	
her	det,pron	
here	adv	
hero	n	
hers	pron	
herself	pron	
hesitate	v	
hey	exclam	
hi	exclam	
hide	v	
high	adj,adv,n	
highlight	n,v	
highly	adv	
hill	n	
him	pron	
himself	pron	
hire	n,v	
his	det,pron	
historic	adj	
historical	adj	
history	n	
hit	n,v	
hobby	n	
hockey	n	
hold	n,v	
hole	n	
holiday	n	
hollow	adj	
holy	adj	
home	adj,adv,n	
homework	n	
honest	adj	
honour	n,v	
hope	n,v	
horrible	adj	
horror	n	
horse	n	
hospital	n	
host	n,v	
hot	adj	
hotel	n	
hour	n	
house	n,v	
household	n	
housing	n	
how	adv	
however	adv	
huge	adj	
human	adj,n	
humorous	adj	
humour	n	
hundred	number	
hungry	adj	
hunt	n,v	
hunting	n	
hurricane	n	
hurry	n,v	
hurt	adj,n,v	
husband	n	
I	pron	
ice	n	
ice cream	n	
idea	n	
ideal	adj,n	
identify	v	
identity	n	
if	conj	
ignore	v	
ill	adj	
illegal	adj	
illness	n	
illustrate	v	
illustration	n	
image	n	
imaginary	adj	
imagination	n	
imagine	v	
immediate	adj	
immediately	adv	
immigrant	n	
impact	n,v	
impatient	adj	
imply	v	
import	n,v	
importance	n	
important	adj	
impose	v	
impossible	adj	
impress	v	
impressed	adj	
impression	n	
impressive	adj	
improve	v	
improvement	n	
in	adv,prep	
inch	n	
incident	n	
include	v	
included	adj	
including	prep	
income	n	
increase	n,v	
increasingly	adv	
incredible	adj	
incredibly	adv	
indeed	adv	
independent	adj	
indicate	v	
indirect	adj	
individual	adj,n	
indoor	adj	
indoors	adv	
industrial	adj	
industry	n	
infection	n	
influence	n,v	
inform	v	
informal	adj	
information	n	
ingredient	n	
initial	adj	
initially	adv	
initiative	n	
injure	v	
injured	adj	
injury	n	
inner	adj	
innocent	adj	
insect	n	
inside	adj,adv,n,prep	
insight	n	
insist	v	
inspire	v	
install	v	
instance	n	
instead	adv	
institute	n	
institution	n	
instruction	n	
instructor	n	
instrument	n	
insurance	n	
intelligence	n	
intelligent	adj	
intend	v	
intended	adj	
intense	adj	
intention	n	
interest	n,v	
interested	adj	
interesting	adj	
internal	adj	
international	adj	
internet	n	
interpret	v	
interrupt	v	
interview	n,v	
into	prep	
introduce	v	
introduction	n	
invent	v	
invention	n	
invest	v	
investigate	v	
investigation	n	
investment	n	
invitation	n	
invite	v	
involve	v	
involved	adj	
iron	n,v	
island	n	
issue	n,v	
IT	n	
it	pron	
item	n	
its	det	
itself	pron	
jacket	n	
jam	n	
January	n	
jazz	n	
jeans	n	
jewellery	n	
job	n	
join	v	
joke	n,v	
journal	n	
journalist	n	
journey	n	
joy	n	
judge	n,v	
judgement	n	
juice	n	
July	n	
jump	n,v	
June	n	
junior	adj	
just	adv	
justice	n	
justify	v	
keen	adj	
keep	v	
key	adj,n,v	
keyboard	n	
kick	n,v	
kid	n	
kill	v	
killing	n	
kilometre	n	
kind	n	(type) 
kind	adj	(caring) 
king	n	
kiss	n,v	
kitchen	n	
knee	n	
knife	n	
knock	n,v	
know	v	
knowledge	n	
lab	n	
label	n,v	
laboratory	n	
labour	n	
lack	n,v	
lady	n	
lake	n	
lamp	n	
land	n,v	
landscape	n	
language	n	
laptop	n	
large	adj	
largely	adv	
last1	adv,det,n	(final) 
last1	v	(taking time) 
late	adj,adv	
later	adj,adv	
latest	adj,n	
laugh	n,v	
laughter	n	
launch	n,v	
law	n	
lawyer	n	
lay	v	
layer	n	
lazy	adj	
lead1	n,v	
leader	n	
leadership	n	
leading	adj	
leaf	n	
league	n	
lean	v	
learn	v	
learning	n	
least	adv,det,pron	
leather	n	
leave	n,v	
lecture	n,v	
left	adj,adv,n	
leg	n	
legal	adj	
leisure	n	
lemon	n	
lend	v	
length	n	
less	adv,det,pron	
lesson	n	
let	v	
letter	n	
level	adj,n,v	
library	n	
licence	n	
lie1	v	
lie2	n,v	(tell a lie) 
life	n	
lifestyle	n	
lift	n,v	
light	adj,n,v	(from the sun/a lamp) 
light	adj	(not heavy) 
like	prep	(similar) 
like	n,v	(find sb/sth pleasant) 
likely	adj	
limit	n,v	
limited	adj	
line	n,v	
link	n,v	
lion	n	
lip	n	
liquid	adj,n	
list	n,v	
listen	v	
listener	n	
literature	n	
little	adj,adv,det,pron	
live1	v	
live2	adj,adv	
lively	adj	
living	adj,n	
load	n,v	
loan	n	
local	adj,n	
locate	v	
located	adj	
location	n	
lock	n,v	
logical	adj	
lonely	adj	
long1	adj,adv	
long-term	adj,adv	
look	n,v	
loose	adj	
lord	n	
lorry	n	
lose	v	
loss	n	
lost	adj	
lot	adv,det,pron	
loud	adj,adv	
loudly	adv	
love	n,v	
lovely	adj	
low	adj,adv,n	
lower	v	
luck	n	
lucky	adj	
lunch	n	
lung	n	
luxury	n	
machine	n	
mad	adj	
magazine	n	
magic	adj,n	
mail	n,v	
main	adj	
mainly	adv	
maintain	v	
major	adj	
majority	n	
make	n,v	
male	adj,n	
mall	n	
man	n	
manage	v	
management	n	
manager	n	
manner	n	
many	det,pron	
map	n,v	
March	n	
mark	n,v	
market	n,v	
marketing	n	
marriage	n	
married	adj	
marry	v	
mass	adj,n	
massive	adj	
master	n,v	
match	n,v	(contest/correspond) 
matching	adj	
material	adj,n	
mathematics	n	
maths	n	
matter	n,v	
maximum	adj,n	
May	n	
may	modal v	
maybe	adv	
me	pron	
meal	n	
mean	v	
meaning	n	
means	n	
meanwhile	adv	
measure	n,v	
measurement	n	
meat	n	
media	n	
medical	adj	
medicine	n	
medium	adj,n	
meet	v	
meeting	n	
melt	v	
member	n	
memory	n	
mental	adj	
mention	n,v	
menu	n	
mess	n,v	
message	n	
metal	n	
method	n	
metre	n	
middle	adj,n	
midnight	n	
might	modal v	
mild	adj	
mile	n	
military	adj,n	
milk	n	
million	number	
mind	n,v	
mine	pron	(belongs to me) 
mine	n	(hole in the ground) 
mineral	n	
minimum	adj,n	
minister	n	
minor	adj	
minority	n	
minute1	n	
mirror	n	
miss	v	
missing	adj	
mission	n	
mistake	n,v	
mix	n,v	
mixed	adj	
mixture	n	
mobile	adj,n	
model	n,v	
modern	adj	
modify	v	
moment	n	
Monday	n	
money	n	
monitor	n,v	
monkey	n	
month	n	
mood	n	
moon	n	
moral	adj,n	
more	adv,det,pron	
morning	n	
most	adv,det,pron	
mostly	adv	
mother	n	
motor	adj,n	
motorcycle	n	
mount	v	
mountain	n	
mouse	n	
mouth	n	
move	n,v	
movement	n	
movie	n	
much	adv,det,pron	
mud	n	
multiple	adj	
multiply	v	
mum	n	
murder	n,v	
muscle	n	
museum	n	
music	n	
musical	adj,n	
musician	n	
must	modal v	
my	det	
myself	pron	
mysterious	adj	
mystery	n	
nail	n	
name	n,v	
narrative	adj,n	
narrow	adj,v	
nation	n	
national	adj,n	
native	adj,n	
natural	adj	
naturally	adv	
nature	n	
near	adj,adv,prep	
nearly	adv	
neat	adj	
necessarily	adv	
necessary	adj	
neck	n	
need	modal v,n,v	
needle	n	
negative	adj,n	
neighbour	n	
neighbourhood	n	
neither	adv,det,pron	
nerve	n	
nervous	adj	
net	n	
network	n	
never	adv	
nevertheless	adv	
new	adj	
news	n	
newspaper	n	
next	adj,adv,n	
next to	prep	
nice	adj	
night	n	
nightmare	n	
nine	number	
nineteen	number	
ninety	number	
no	det,exclam	
noone	pron	
nobody	pron	
noise	n	
noisy	adj	
none	pron	
nor	adv,conj	
normal	adj,n	
normally	adv	
north	adj,adv,n	
northern	adj	
nose	n	
not	adv	
note	n,v	
nothing	pron	
notice	n,v	
notion	n	
novel	n	
November	n	
now	adv,conj	
nowhere	adv	
nuclear	adj	
number	n,v	
numerous	adj	
nurse	n	
nut	n	
obey	v	
object	n,v	
objective	adj,n	
obligation	n	
observation	n	
observe	v	
obtain	v	
obvious	adj	
obviously	adv	
occasion	n	
occasionally	adv	
occur	v	
ocean	n	
o'clock	adv	
October	n	
odd	adj	
of	prep	
off	adv,prep	
offence	n	
offend	v	
offensive	adj	
offer	n,v	
office	n	
officer	n	
official	adj,n	
often	adv	
oh	exclam	
oil	n	
OK	adj,adv,exclam	
old	adj	
old-fashioned	adj	
on	adv,prep	
once	adv,conj	
one	det,number,pron	
onion	n	
online	adj,adv	
only	adj,adv	
onto	prep	
open	adj,v	
opening	n	
operate	v	
operation	n	
opinion	n	
opponent	n	
opportunity	n	
oppose	v	
opposed	adj	
opposite	adj,adv,n,prep	
opposition	n	
option	n	
or	conj	
orange	adj,n	
order	n,v	
ordinary	adj	
organ	n	
organization	n	
organize	v	
organized	adj	
organizer	n	
origin	n	
original	adj,n	
originally	adv	
other	adj,pron	
otherwise	adv	
ought	modal v	
our	det	
ours	pron	
ourselves	pron	
out	adv,prep	
outcome	n	
outdoor	adj	
outdoors	adv	
outer	adj	
outline	n,v	
outside	adj,adv,prep	
oven	n	
over	adv,prep	
overall	adj,adv	
owe	v	
own	adj,pron,v	
owner	n	
pace	n,v	
pack	n,v	
package	n,v	
page	n	
pain	n	
painful	adj	
paint	n,v	
painter	n	
painting	n	
pair	n	
palace	n	
pale	adj	
pan	n	
panel	n	
pants	n	
paper	n	
paragraph	n	
parent	n	
park	n,v	
parking	n	
parliament	n	
part	n	
participant	n	
participate	v	
particular	adj	
particularly	adv	
partly	adv	
partner	n	
party	n	
pass	n,v	
passage	n	
passenger	n	
passion	n	
passport	n	
past	adj,adv,n,prep	
path	n	
patient	adj,n	
pattern	n	
pay	n,v	
payment	n	
peace	n	
peaceful	adj	
pen	n	
pencil	n	
penny	n	
pension1	n	
people	n	
pepper	n	
per	prep	
percent	adj,adv,n	
percentage	n	
perfect	adj	
perfectly	adv	
perform	v	
performance	n	
perhaps	adv	
period	n	
permanent	adj	
permission	n	
permit	n,v	
person	n	
personal	adj	
personality	n	
personally	adv	
perspective	n	
persuade	v	
pet	n	
petrol	n	
phase	n	
phenomenon	n	
philosophy	n	
phone	n,v	
photo	n	
photograph	n,v	
photographer	n	
photography	n	
phrase	n	
physical	adj	
physics	n	
piano	n	
pick	n,v	
picture	n,v	
piece	n	
pig	n	
pile	n,v	
pilot	n	
pin	n,v	
pink	adj,n	
pipe	n	
pitch	n	
place	n,v	
plain	adj	
plan	n,v	
plane	n	
planet	n	
planning	n	
plant	n,v	
plastic	adj,n	
plate	n	
platform	n	
play	n,v	
player	n	
pleasant	adj	
please	exclam,v	
pleased	adj	
pleasure	n	
plenty	pron	
plot	n,v	
plus	adj,conj,n,prep	
pocket	n	
poem	n	
poet	n	
poetry	n	
point	n,v	
pointed	adj	
poison	n,v	
poisonous	adj	
police	n	
policeman	n	
policy	n	
polite	adj	
political	adj	
politician	n	
politics	n	
pollution	n	
pool	n	
poor	adj	
pop	adj,n	
popular	adj	
popularity	n	
population	n	
port	n	
portrait	n	
pose	v	
position	n,v	
positive	adj,n	
possess	v	
possession	n	
possibility	n	
possible	adj	
possibly	adv	
post	n,v	
poster	n	
pot	n	
potato	n	
potential	adj,n	
pound	n	
pour	v	
poverty	n	
powder	n	
power	n,v	
powerful	adj	
practical	adj	
practice	n	
practise	v	
praise	n,v	
pray	v	
prayer	n	
predict	v	
prediction	n	
prefer	v	
pregnant	adj	
preparation	n	
prepare	v	
prepared	adj	
presence	n	
present	adj,n,v	
presentation	n	
preserve	v	
president	n	
press	n,v	
pressure	n	
pretend	v	
pretty	adj,adv	
prevent	v	
previous	adj	
previously	adv	
price	n,v	
priest	n	
primary	adj	
prime	adj	
prince	n	
princess	n	
principle	n	
print	n,v	
printer	n	
printing	n	
priority	n	
prison	n	
prisoner	n	
privacy	n	
private	adj	
prize	n	
probably	adv	
problem	n	
procedure	n	
process	n,v	
produce	v	
producer	n	
product	n	
production	n	
profession	n	
professional	adj,n	
professor	n	
profile	n	
profit	n	
program	n,v	
programme	n	
progress	n,v	
project	n,v	
promise	n,v	
promote	v	
pronounce	v	
proof	n	
proper	adj	
properly	adv	
property	n	
proposal	n	
propose	v	
prospect	n	
protect	v	
protection	n	
protest	n,v	
proud	adj	
prove	v	
provide	v	
psychologist	n	
psychology	n	
pub	n	
public	adj,n	
publication	n	
publish	v	
pull	n,v	
punish	v	
punishment	n	
pupil	n	
purchase	n,v	
pure	adj	
purple	adj,n	
purpose	n	
pursue	v	
push	n,v	
put	v	
qualification	n	
qualified	adj	
qualify	v	
quality	n	
quantity	n	
quarter	n	
queen	n	
question	n,v	
queue	n,v	
quick	adj	
quickly	adv	
quiet	adj	
quietly	adv	
quit	v	
quite	adv	
quotation	n	
quote	n,v	
race	n,v	(competition) 
race	n	(people) 
racing	n	
radio	n	
railway	n	
rain	n,v	
raise	v	
range	n,v	
rank	n,v	
rapid	adj	
rapidly	adv	
rare	adj	
rarely	adv	
rate	n,v	
rather	adv	
raw	adj	
reach	n,v	
react	v	
reaction	n	
read	v	
reader	n	
reading	n	
ready	adj	
real	adj	
realistic	adj	
reality	n	
realize	v	
really	adv	
reason	n	
reasonable	adj	
recall	v	
receipt	n	
receive	v	
recent	adj	
recently	adv	
reception	n	
recipe	n	
recognize	v	
recommend	v	
recommendation	n	
record	n,v	
recording	n	
recover	v	
recycle	v	
red	adj,n	
reduce	v	
reduction	n	
refer	v	
reference	n	
reflect	v	
refuse1	v	
regard	n,v	
region	n	
regional	adj	
register	n,v	
regret	n,v	
regular	adj	
regularly	adv	
regulation	n	
reject	v	
relate	v	
related	adj	
relation	n	
relationship	n	
relative	adj,n	
relatively	adv	
relax	v	
relaxed	adj	
relaxing	adj	
release	n,v	
relevant	adj	
reliable	adj	
relief	n	
religion	n	
religious	adj	
rely	v	
remain	v	
remark	n,v	
remember	v	
remind	v	
remote	adj	
remove	v	
rent	n,v	
repair	n,v	
repeat	n,v	
repeated	adj	
replace	v	
reply	n,v	
report	n,v	
reporter	n	
represent	v	
representative	adj,n	
reputation	n	
request	n,v	
require	v	
requirement	n	
rescue	n,v	
research	n,v	
researcher	n	
reservation	n	
reserve	n,v	
resident	adj,n	
resist	v	
resolve	v	
resort	n	
resource	n	
respect	n,v	
respond	v	
response	n	
responsibility	n	
responsible	adj	
rest	n	(remaining part) 
rest	n,v	(sleep/relax) 
restaurant	n	
result	n,v	
retain	v	
retire	v	
retired	adj	
return	n,v	
reveal	v	
review	n,v	
revise	v	
revolution	n	
reward	n,v	
rhythm	n	
rice	n	
rich	adj	
rid	v	
ride	n,v	
right	adj,adv,n	
ring1	n	
ring2	n,v	
rise	n,v	
risk	n,v	
river	n	
road	n	
robot	n	
rock	n	(stone) 
rock	n	(music) 
role	n	
roll	n,v	
romantic	adj	
roof	n	
room	n	
root	n	
rope	n	
rough	adj	
round	adj,adv,n,prep	
route	n	
routine	adj,n	
row1	n	
royal	adj	
rub	v	
rubber	adj,n	
rubbish	n	
rude	adj	
rugby	n	
rule	n,v	
run	n,v	
runner	n	
running	n	
rural	adj	
rush	n,v	
sad	adj	
sadly	adv	
safe	adj	
safety	n	
sail	n,v	
sailing	n	
sailor	n	
salad	n	
salary	n	
sale	n	
salt	n	
same	adj,adv,pron	
sample	n,v	
sand	n	
sandwich	n	
satellite	n	
satisfied	adj	
satisfy	v	
Saturday	n	
sauce	n	
save	v	
saving	n	
say	v	
scale	n	
scan	v	
scared	adj	
scary	adj	
scene	n	
schedule	n,v	
scheme	n	
school	n	
science	n	
scientific	adj	
scientist	n	
score	n,v	
scream	n,v	
screen	n,v	
script	n	
sculpture	n	
sea	n	
search	n,v	
season	n	
seat	n,v	
second	adv,det,number	(next after the first) 
second	n	(unit of time) 
secondary	adj	
secondly	adv	
secret	adj,n	
secretary	n	
section	n	
sector	n	
secure	adj,v	
security	n	
see	v	
seed	n	
seek	v	
seem	v	
select	v	
selection	n	
self	n	
sell	v	
send	v	
senior	adj	
sense	n,v	
sensible	adj	
sensitive	adj	
sentence	n,v	
separate	adj,v	
September	n	
sequence	n	
series	n	
serious	adj	
seriously	adv	
servant	n	
serve	v	
service	n	
session	n	
set	v	(put) 
set	n	(group) 
setting	n	
settle	v	
seven	number	
seventeen	number	
seventy	number	
several	det,pron	
severe	adj	
sex	n	
sexual	adj	
shade	n	
shadow	n	
shake	n,v	
shall	modal v	
shallow	adj	
shame	n	
shape	n,v	
share	n,v	
sharp	adj	
she	pron	
sheep	n	
sheet	n	
shelf	n	
shell	n	
shelter	n,v	
shift	n,v	
shine	v	
shiny	adj	
ship	n,v	
shirt	n	
shock	n,v	
shocked	adj	
shoe	n	
shoot	v	
shooting	n	
shop	n,v	
shopping	n	
short	adj	
shot	n	
should	modal v	
shoulder	n	
shout	n,v	
show	n,v	
shower	n	
shut	adj,v	
shy	adj	
sick	adj	
side	n	
sight	n	
sign	n,v	
signal	n,v	
significant	adj	
significantly	adv	
silence	n	
silent	adj	
silk	n	
silly	adj	
silver	adj,n	
similar	adj	
similarity	n	
similarly	adv	
simple	adj	
simply	adv	
since	adv,conj,prep	
sincere	adj	
sing	v	
singer	n	
singing	n	
single	adj,n	
sink	v	
sir	n	
sister	n	
sit	v	
site	n	
situation	n	
six	number	
sixteen	number	
sixty	number	
size	n	
ski	n,v	
skiing	n	
skill	n	
skin	n	
skirt	n	
sky	n	
slave	n	
sleep	n,v	
slice	n,v	
slide	n,v	
slight	adj	
slightly	adv	
slip	v	
slope	n,v	
slow	adj,v	
slowly	adv	
small	adj	
smart	adj	
smartphone	n	
smell	n,v	
smile	n,v	
smoke	n,v	
smoking	n	
smooth	adj	
snake	n	
snow	n,v	
so	adv,conj	
soap	n	
soccer	n	
social	adj	
society	n	
sock	n	
soft	adj	
software	n	
soil	n	
solar	adj	
soldier	n	
solid	adj,n	
solution	n	
solve	v	
some	det,pron	
somebody	pron	
someone	pron	
something	pron	
sometimes	adv	
somewhat	adv	
somewhere	adv,pron	
son	n	
song	n	
soon	adv	
sorry	adj,exclam	
sort	n,v	
soul	n	
sound	n,v	
soup	n	
source	n	
south	adj,adv,n	
southern	adj	
space	n	
speak	v	
speaker	n	
special	adj	
specialist	adj,n	
species	n	
specific	adj	
specifically	adv	
speech	n	
speed	n,v	
spell	v	
spelling	n	
spend	v	
spending	n	
spicy	adj	
spider	n	
spirit	n	
spiritual	adj	
split	n,v	
spoken	adj	
sponsor	n,v	
spoon	n	
sport	n	
spot	n,v	
spread	n,v	
spring	n,v	
square	adj,n	
stable	adj	
stadium	n	
staff	n	
stage	n,v	
stair	n	
stamp	n	
stand	n,v	
standard	adj,n	
star	n,v	
stare	v	
start	n,v	
state	adj,n,v	
statement	n	
station	n	
statistic	n	
statue	n	
status	n	
stay	n,v	
steady	adj	
steal	v	
steel	n	
steep	adj	
step	n,v	
stick	v	(push into/attach) 
stick	n	(piece of wood) 
sticky	adj	
stiff	adj	
still	adj,adv	
stock	n	
stomach	n	
stone	n	
stop	n,v	
store	n,v	
storm	n	
story	n	
straight	adj,adv	
strange	adj	
stranger	n	
strategy	n	
stream	n	
street	n	
strength	n	
stress	n,v	
stretch	n,v	
strict	adj	
strike	n,v	
string	n	
strong	adj	
strongly	adv	
structure	n,v	
struggle	n,v	
student	n	
studio	n	
study	n,v	
stuff	n,v	
stupid	adj	
style	n	
subject	adj,n	
submit	v	
substance	n	
succeed	v	
success	n	
successful	adj	
successfully	adv	
such	det,pron	
sudden	adj	
suddenly	adv	
suffer	v	
sugar	n	
suggest	v	
suggestion	n	
suit	n,v	
suitable	adj	
sum	n,v	
summarize	v	
summary	n	
summer	n	
sun	n	
Sunday	n	
supermarket	n	
supply	n,v	
support	n,v	
supporter	n	
suppose	v	
sure	adj,adv	
surely	adv	
surface	n	
surgery	n	
surprise	n,v	
surprised	adj	
surprising	adj	
surround	v	
surrounding	adj	
survey	n,v	
survive	v	
suspect	n,v	
swear	v	
sweater	n	
sweep	v	
sweet	adj,n	
swim	n,v	
swimming	n	
switch	n,v	
symbol	n	
sympathy	n	
symptom	n	
system	n	
table	n	
tablet	n	
tail	n	
take	v	
tale	n	
talent	n	
talented	adj	
talk	n,v	
tall	adj	
tank	n	
tape	n	
target	n,v	
task	n	
taste	n,v	
tax	n,v	
taxi	n	
tea	n	
teach	v	
teacher	n	
teaching	n	
team	n	
tear1	n,v	
tear2	n	
technical	adj	
technique	n	
technology	n	
teenage	adj	
teenager	n	
telephone	n,v	
television	n	
tell	v	
temperature	n	
temporary	adj	
ten	number	
tend	v	
tennis	n	
tent	n	
term	n,v	
terrible	adj	
test	n,v	
text	n,v	
than	conj	
thank	v	
thanks	exclam,n	
that	adv,conj,det,pron	
theatre	n	
their	det	
theirs	pron	
them	pron	
theme	n	
themselves	pron	
then	adv	
theory	n	
therapy	n	
there	adv	
therefore	adv	
they	pron	
thick	adj	
thief	n	
thin	adj	
thing	n	
think	v	
thinking	n	
third	n,number	
thirsty	adj	
thirteen	number	
thirty	number	
this	adv,det,pron	
though	adv,conj	
thought	n	
thousand	number	
threat	n	
threaten	v	
three	number	
throat	n	
through	adv,prep	
throughout	adv,prep	
throw	v	
Thursday	n	
thus	adv	
ticket	n	
tidy	adj,v	
tie	n,v	
tight	adj	
till	conj,prep	
time	n,v	
tin	n	
tiny	adj	
tip	n,v	
tired	adj	
title	n,v	
to	prep	
today	adv,n	
toe	n	
together	adv	
toilet	n	
tomato	n	
tomorrow	adv,n	
tone	n	
tongue	n	
tonight	adv,n	
too	adv	
tool	n	
tooth	n	
top	adj,n	
topic	n	
total	adj,n	
totally	adv	
touch	n,v	
tough	adj	
tour	n,v	
tourism	n	
tourist	n	
towards	prep	
towel	n	
tower	n	
town	n	
toy	adj,n	
track	n,v	
trade	n,v	
tradition	n	
traditional	adj	
traffic	n	
train	n,v	
trainer	n	
training	n	
transfer	n,v	
transform	v	
transition	n	
translate	v	
translation	n	
transport	n,v	
travel	n,v	
traveller	n	
treat	v	
treatment	n	
tree	n	
trend	n	
trial	n	
trick	n,v	
trip	n,v	
tropical	adj	
trouble	n,v	
trousers	n	
truck	n	
true	adj	
truly	adv	
trust	n,v	
truth	n	
try	n,v	
T-shirt	n	
tube	n	
Tuesday	n	
tune	n	
tunnel	n	
turn	n,v	
TV	n	
twelve	number	
twenty	number	
twice	adv	
twin	adj,n	
two	number	
type	n,v	
typical	adj	
typically	adv	
tyre	n	
ugly	adj	
ultimately	adv	
umbrella	n	
unable	adj	
uncle	n	
uncomfortable	adj	
unconscious	adj	
under	adv,prep	
underground	adj,adv	
understand	v	
understanding	n	
underwear	n	
unemployed	adj	
unemployment	n	
unexpected	adj	
unfair	adj	
unfortunately	adv	
unhappy	adj	
uniform	n	
union	n	
unique	adj	
unit	n	
united	adj	
universe	n	
university	n	
unknown	adj	
unless	conj	
unlike	prep	
unlikely	adj	
unnecessary	adj	
unpleasant	adj	
until	conj,prep	
unusual	adj	
up	adv,prep	
update	n,v	
upon	prep	
upper	adj	
upset	adj,v	
upstairs	adj,adv	
upwards	adv	
urban	adj	
urge	v	
us	pron	
use	n,v	
used1	adj	
used2	adj	
used to	modal v	
useful	adj	
user	n	
usual	adj	
usually	adv	
vacation	n	
valley	n	
valuable	adj	
value	n,v	
van	n	
variety	n	
various	adj	
vary	v	
vast	adj	
vegetable	n	
vehicle	n	
venue	n	
version	n	
very	adj,adv	
via	prep	
victim	n	
victory	n	
video	n	
view	n,v	
viewer	n	
village	n	
violence	n	
violent	adj	
virtual	adj	
virus	n	
vision	n	
visit	n,v	
visitor	n	
visual	adj	
vital	adj	
vitamin	n	
voice	n	
volume	n	
volunteer	n,v	
vote	n,v	
wage	n	
wait	n,v	
waiter	n	
wake	v	
walk	n,v	
wall	n	
want	v	
war	n	
warm	adj,v	
warn	v	
warning	n	
wash	n,v	
washing	n	
waste	adj,n,v	
watch	n,v	
water	n,v	
wave	n,v	
way	adv,n	
we	pron	
weak	adj	
weakness	n	
wealth	n	
wealthy	adj	
weapon	n	
wear	v	
weather	n	
web	n	
website	n	
wedding	n	
Wednesday	n	
week	n	
weekend	n	
weigh	v	
weight	n	
welcome	adj,exclam,n,v	
well	adj,adv,exclam	
west	adj,adv,n	
western	adj	
wet	adj	
what	det,pron	
whatever	det,pron	
wheel	n	
when	adv,conj,pron	
whenever	conj	
where	adv,conj	
whereas	conj	
wherever	conj	
whether	conj	
which	det,pron	
while	conj,n	
whisper	n,v	
white	adj,n	
who	pron	
whole	adj,n	
whom	pron	
whose	det,pron	
why	adv	
wide	adj	
widely	adv	
wife	n	
wild	adj	
wildlife	n	
will	modal v,n	
willing	adj	
win	n,v	
wind1	n	
wind2	v	
window	n	
wine	n	
wing	n	
winner	n	
winter	n	
wire	n	
wise	adj	
wish	n,v	
with	prep	
within	prep	
without	prep	
witness	n,v	
woman	n	
wonder	n,v	
wonderful	adj	
wood	n	
wooden	adj	
wool	n	
word	n	
work	n,v	
worker	n	
working	adj	
world	n	
worldwide	adj,adv	
worried	adj	
worry	n,v	
worse	adj,adv,n	
worst	adj,adv,n	
worth	adj,n	
would	modal v	
wound	n,v	
wow	exclam	
wrap	v	
write	v	
writer	n	
writing	n	
written	adj	
wrong	adj,adv,n	
yard	n	
yeah	exclam	
year	n	
yellow	adj,n	
yes	exclam	
yesterday	adv,n	
yet	adv,conj	
you	pron	
young	adj,n	
your	det	
yours	pron	
yourself	pron	
youth	n	
zero	number	
zone	n	
